list	liste
client	istemci
recursion	ozyineleme
binary	ikili
friend	arkadas
overloading	asiri_yukleme
signal	sinyal
array	dizi
circuit	devre
data	veri
inheritance	miraslama
object	nesne
priority	oncelik
server	sunucu
stack	yigin
ambiguous	belirsiz
artificial	yapay
child	cocuk
class	sinif
compiler	derleyici
external	harici
gate	kapi
linked	bagli
nuts	findik
order	sira_duzen
parent	ebeveyn
queue	kuyruk
root	kok
sibling	kardes
sorting	siralama
tree	agac